11111111111
1C101C101C1
1000001C001
1P110110101
1E1C000C1C1
11111111111
