1111111111111
1C0P00C0000C1
1000011111001
1P00P1E000001
1111111111111
