11111111111
1C101C1E1C1
1000001C001
1P110100101
1E1E000E1C1
11111111111
