11111111111
10101010101
10000010001
1P110100101
1E1000001C1
11111111111
11111111111
10101010101
10000010001
1P110100101
1E100000101
11111111111
