1111111111111
100P0000000C1
10000E0011001
1P00PPE000001
1111111111111
