1111111
1C0P001
10001C1
1P00111
10X00X1
100X001
1E01C01
1111111
