11111111111111111
1C0P00C0X00C100C1
10000110110000X01
1P00P1E0000010001
11111111111111111
