11111111111111
1C0P001C0000C1
101010C0111101
1P0C1010000X01
11011010111101
110X00C01CC101
1E01C0100X00C1
11111111111111
