11111111111111
1C0P00000000C1
10001C00111001
1P001100000X01
10000000111001
100X00001C1001
1E01C0000X0001
11111111111111
