1111111111111
100100000E0C1
1000011111001
100P1100e0001
1111111111111
