11111111111
01111111111
11111111111
