11111111111
11111111110
11111111111
